/projects/piml_inversion/ljlozenski/acoustic_measurments/dataset0.npy	/projects/piml_inversion/ljlozenski/velocity_maps/dataset0.npy
/projects/piml_inversion/ljlozenski/acoustic_measurments/dataset1.npy	/projects/piml_inversion/ljlozenski/velocity_maps/dataset1.npy
/projects/piml_inversion/ljlozenski/acoustic_measurments/dataset2.npy	/projects/piml_inversion/ljlozenski/velocity_maps/dataset2.npy
/projects/piml_inversion/ljlozenski/acoustic_measurments/dataset3.npy	/projects/piml_inversion/ljlozenski/velocity_maps/dataset3.npy
/projects/piml_inversion/ljlozenski/acoustic_measurments/dataset4.npy	/projects/piml_inversion/ljlozenski/velocity_maps/dataset4.npy
/projects/piml_inversion/ljlozenski/acoustic_measurments/dataset5.npy	/projects/piml_inversion/ljlozenski/velocity_maps/dataset5.npy
/projects/piml_inversion/ljlozenski/acoustic_measurments/dataset6.npy	/projects/piml_inversion/ljlozenski/velocity_maps/dataset6.npy
/projects/piml_inversion/ljlozenski/acoustic_measurments/dataset7.npy	/projects/piml_inversion/ljlozenski/velocity_maps/dataset7.npy
/projects/piml_inversion/ljlozenski/acoustic_measurments/dataset8.npy	/projects/piml_inversion/ljlozenski/velocity_maps/dataset8.npy
/projects/piml_inversion/ljlozenski/acoustic_measurments/dataset9.npy	/projects/piml_inversion/ljlozenski/velocity_maps/dataset9.npy
/projects/piml_inversion/ljlozenski/acoustic_measurments/dataset10.npy	/projects/piml_inversion/ljlozenski/velocity_maps/dataset10.npy
/projects/piml_inversion/ljlozenski/acoustic_measurments/dataset11.npy	/projects/piml_inversion/ljlozenski/velocity_maps/dataset11.npy
/projects/piml_inversion/ljlozenski/acoustic_measurments/dataset12.npy	/projects/piml_inversion/ljlozenski/velocity_maps/dataset12.npy
/projects/piml_inversion/ljlozenski/acoustic_measurments/dataset13.npy	/projects/piml_inversion/ljlozenski/velocity_maps/dataset13.npy
/projects/piml_inversion/ljlozenski/acoustic_measurments/dataset14.npy	/projects/piml_inversion/ljlozenski/velocity_maps/dataset14.npy
/projects/piml_inversion/ljlozenski/acoustic_measurments/dataset15.npy	/projects/piml_inversion/ljlozenski/velocity_maps/dataset15.npy
/projects/piml_inversion/ljlozenski/acoustic_measurments/dataset16.npy	/projects/piml_inversion/ljlozenski/velocity_maps/dataset16.npy
/projects/piml_inversion/ljlozenski/acoustic_measurments/dataset17.npy	/projects/piml_inversion/ljlozenski/velocity_maps/dataset17.npy
/projects/piml_inversion/ljlozenski/acoustic_measurments/dataset18.npy	/projects/piml_inversion/ljlozenski/velocity_maps/dataset18.npy
/projects/piml_inversion/ljlozenski/acoustic_measurments/dataset19.npy	/projects/piml_inversion/ljlozenski/velocity_maps/dataset19.npy
/projects/piml_inversion/ljlozenski/acoustic_measurments/dataset20.npy	/projects/piml_inversion/ljlozenski/velocity_maps/dataset20.npy
/projects/piml_inversion/ljlozenski/acoustic_measurments/dataset21.npy	/projects/piml_inversion/ljlozenski/velocity_maps/dataset21.npy
/projects/piml_inversion/ljlozenski/acoustic_measurments/dataset22.npy	/projects/piml_inversion/ljlozenski/velocity_maps/dataset22.npy
/projects/piml_inversion/ljlozenski/acoustic_measurments/dataset23.npy	/projects/piml_inversion/ljlozenski/velocity_maps/dataset23.npy
/projects/piml_inversion/ljlozenski/acoustic_measurments/dataset24.npy	/projects/piml_inversion/ljlozenski/velocity_maps/dataset24.npy
/projects/piml_inversion/ljlozenski/acoustic_measurments/dataset25.npy	/projects/piml_inversion/ljlozenski/velocity_maps/dataset25.npy
/projects/piml_inversion/ljlozenski/acoustic_measurments/dataset26.npy	/projects/piml_inversion/ljlozenski/velocity_maps/dataset26.npy
/projects/piml_inversion/ljlozenski/acoustic_measurments/dataset27.npy	/projects/piml_inversion/ljlozenski/velocity_maps/dataset27.npy
/projects/piml_inversion/ljlozenski/acoustic_measurments/dataset28.npy	/projects/piml_inversion/ljlozenski/velocity_maps/dataset28.npy
/projects/piml_inversion/ljlozenski/acoustic_measurments/dataset29.npy	/projects/piml_inversion/ljlozenski/velocity_maps/dataset29.npy
/projects/piml_inversion/ljlozenski/acoustic_measurments/dataset30.npy	/projects/piml_inversion/ljlozenski/velocity_maps/dataset30.npy
/projects/piml_inversion/ljlozenski/acoustic_measurments/dataset31.npy	/projects/piml_inversion/ljlozenski/velocity_maps/dataset31.npy
/projects/piml_inversion/ljlozenski/acoustic_measurments/dataset32.npy	/projects/piml_inversion/ljlozenski/velocity_maps/dataset32.npy
